21 21
██████  ██████████████████████████████████
██      ██  ██                  ██  ██  ██
██████  ██  ██████  ██████████████  ██  ██
██          ██      ██      ██      ██  ██
██████  ██  ██████  ██  ██████  ██████  ██
██  ██  ██      ██      ██      ██      ██
██  ██  ██  ██  ██  ██████  ██  ██  ██  ██
██      ██  ██              ██      ██  ██
██  ██████████  ██████  ██████████  ██████
██      ██  ██      ██          ██      ██
██████████  ██  ██  ██  ██████████  ██████
██  ██          ██  ██          ██  ██  ██
██  ██  ██████  ██  ██  ██  ██████████  ██
██      ██      ██  ██  ██              ██
██  ██  ██████████████████████  ██  ██████
██  ██          ██  ██          ██      ██
██  ██████████████  ██  ██████  ██  ██  ██
██  ██      ██              ██  ██  ██  ██
██  ██████  ██████  ██████████████  ██████
██          ██      ██                  ██
██████████████████  ██████████████████████
